1111111111111111111111111111111111
1P000000000001000000000000000000C1
1111011111101111111011111111011101
1C00000001C00000000C01000000000001
1011110111A11A1111A101111101111111
101000000010000000000000010000C111
1010111111101111111011110111111111
10000A000A0001C000A000100000000001
1011111011110111111101111111011101
1C01000001C0000011C0000000C10000E1
1111111111111111111111111111111111
