11111111
10EP0001
10000001
10000001
10000001
1000C001
11111111