1111111111111111111111111111111111
1E00000000000000000100000000000001
1010010100100000101001000000010101
1010010010101010001001000000010101
1000000000000000000000000000000001
100000000C000000000C00000000000001
100000000000000C000000110000000001
100000000000000000000C000000000001
1P0000000C000000000000000000000001
1111111111111111111111111111111111