000000000000
111111111111
EPEPEPEPEPEP