111111111111111111111111
010101001010101010101010
CCCCCCCCCCCCCCCCCCCCCCCP
EEEPEPEPEPEPEPEPEPEPEPE0 


PONERRR FT_IS SPACE