1111111111111111111111
1110000000P00000000111
1C100000000000000001C1
1110000000000000000111
1110000000000000000111
1C100000000000000001C1
1110000000E00000000111
1111111111111111111111
