1111111111111111111111111111111111
1P000000C0000000000000000000000001
1010111111011111101111111111011101
10001000C1000C00001C0000000001C001
1011101111111111111111111111111101
100000000000000C000000000000000001
1011111111111011111111011111111100
1C000000000000000000C1C00000000001
1011111111111111111111111111111101
100000000000C0000000000000000000E1
1111111111111111111111111111111111