1111111111111111111
1P00000000000000001
1111111111000000001
1000000000111111111
1111111111000000C01
1000000000111111111
1000000000E00000001
1111111111111111111
