111111111111111111111111111111111111111111111111111111111111
1P0000000000000000000000000000000000000000000000000000000001
100000000000000000000000000000000000000000000000000000000001
100000000000000000000C0000C00CCCCCC0000000000000000000000001
100000000000000000000C0000C00000000C000000000000000000000001
100000000000000000000C0000C000000000C00000000000000000000001
100000000000000000000C0000C000000000C00000000000000000000001
100000000000000000000CCCCCC000000000C00000000000000000000001
10000000000000000000000000C00CCCCCCC000000000000000000000001
10000000000000000000000000C00C000000000000000000000000000001
10000000000000000000000000C00C000000000000000000000000000001
10000000000000000000000000C000C00000000000000000000000000001
10000000000000000000000000C0000CCCCCCC0000000000000000000001
100000000000000000000000000000000000000000000000000000000CC1
100000000000000000000000000000000000000000000000000000000CE1
111111111111111111111111111111111111111111111111111111111111