11111111111111111111111111111111111111111111111111111111111111111111111111
1P00000000000000000000000000000000A0000000000000000000000000000000000000C1
11111111111111111111111111111111111111111111111111111111111111111111111101
1C00000000000000000000000000000000A000000000000000000000000000000000000001
10111111111111111111111111111111111111111111111111111111111111111111111111
1000000000000000000000000000000000A0000000000000000000000000000000000000C1
11111111111111111111111111111111111111111111111111111111111111111111111101
1C00000000000000000000000000000000A000000000000000000000000000000000000001
10111111111111111111111111111111111111111111111111111111111111111111111111
1000000000000000000000000000000000A0000000000000000000000000000000000000C1
11111111111111111111111111111111111111111111111111111111111111111111111101
1C00000000000000000000000000000000A000000000000000000000000000000000000001
10111111111111111111111111111111111111111111111111111111111111111111111111
1000000000000000000000000000000000A0000000000000000000000000000000000000C1
11111111111111111111111111111111111111111111111111111111111111111111111101
1C00000000000000000000000000000000A000000000000000000000000000000000000001
10111111111111111111111111111111111111111111111111111111111111111111111111
1000000000000000000000000000000000A0000000000000000000000000000000000000C1
11111111111111111111111111111111111111111111111111111111111111111111111101
1C00000000000000000000000000000000A000000000000000000000000000000000000001
10111111111111111111111111111111111111111111111111111111111111111111111111
1000000000000000000000000000000000A0000000000000000000000000000000000000C1
11111111111111111111111111111111111111111111111111111111111111111111111101
1E00000000000000000000000000000000A000000000000000000000000000000000000001
11111111111111111111111111111111111111111111111111111111111111111111111111
