1111111111111111111111111111111111
1P0000000000A1C00000000000000000C1
1111011111101111111011111111011101
1C00000001C00000000C01A0000000A001
1011110111111111111101111101111111
101A00000010000000000000010000C111
1010111111101111111011110111111111
10000000000001C000000A100000000001
1011111011110111111101111111011101
1CA1000001C00A0011C0000000C1A000E1
1111111111111111111111111111111111
