111111111111111111111111111111111111111111111111111111111111
1P0000000000000000000000000000000000000000000000000000000001
100000000000000000000000000000000000000000000000000000000001
100000000000000000000A0000A00AAAAAA0000000000000000000000001
100000000000000000000A0000A00000000A000000000000000000000001
100000000000000000000A0000A000000000A00000000000000000000001
100000000000000000000A0000A000000000A00000000000000000000001
100000000000000000000AAAAAA000000000A00000000000000000000001
10000000000000000000000000A00AAAAAAA000000000000000000000001
10000000000000000000000000A00A000000000000000000000000000001
10000000000000000000000000A00A000000000000000000000000000001
10000000000000000000000000A000A00000000000000000000000000001
10000000000000000000000000A0000AAAAAAA0000000000000000000001
100000000000000000000000000000000000000000000000000000000CC1
100000000000000000000000000000000000000000000000000000000CE1
111111111111111111111111111111111111111111111111111111111111
