1111111111111111111111111111111111
1P000000C0000A00000000000000000001
1010111111011111101111111111011101
100A1000C1000C00001C0000000001AC01
1011101111111111111111111111111101
100000000000000C000000000000000001
1011111111111011111111011111111101
1C00000A000000000000C1C0000A000001
1011111111111111111111111111111101
100000000000CA000000000000000000E1
1111111111111111111111111111111111
